############################################################
#############################.##.###########....############
############################################......##########
###########...........######.......#########.......#########
###########...........#####........#######.........#########
##########............#####.........#####...........########
##########............###............####...........########
##########............##.............####.............######
##########....##......##.....##......####.................##
#######.......##......##.....##......########.............##
#####.................##.............###########..........##
###...................##..............############........##
##....................##..............##################..##
#.....................##....................############...#
#.....................##...................................#
#.......##............##..........##.......................#
#.......##............##..........##.......................#
#.....................##............................##.....#
#...................................................##.....#
#..........................................................#
#.....................#######...............#..............#
#....................#########.............###............##
##.................#############.........#######.........###
###..............#################......##########.....#####
############################################################
