|==========================================================|
|..........................................................|
|...|==========|...........................................|
|...|          |...........................................|
|...|          |===========|=============|.................|
|...|                                    |......|========|.|
|...|          |===========|             |......|        |.|
|...|          |...........|             |......|        |.|
|...|          |...........|             |......|        |.|
|...|==========|...........|             |......|        |.|
|..........................|             |======|        |.|
|..........................|                             |.|
|..|=============|.........|                             |.|
|..|             |.........|             |======|        |.|
|..|             |.........|             |......|        |.|
|..|             |=========|             |......|        |.|
|..|                                     |......|        |.|
|..|             |=========|             |......|========|.|
|..|             |.........|             |.................|
|..|             |.........|             |.................|
|..|=============|.........|=============|.................|
|..........................................................|
|..........................................................|
|..........................................................|
|==========================================================|
