|==========================================================|
|                                                          |
|   |==========|                                           |
|   |          |                                           |
|   |          |===========|=============|                 |
|   |                                    |      |========| |
|   |          |===========|             |      |        | |
|   |          |           |             |      |        | |
|   |          |           |             |      |        | |
|   |==========|           |             |      |        | |
|                          |             |======|        | |
|                          |                             | |
|  |=============|         |                             | |
|  |             |         |             |======|        | |
|  |             |         |             |      |        | |
|  |             |=========|             |      |        | |
|  |                                     |      |        | |
|  |             |=========|             |      |========| |
|  |             |         |             |                 |
|  |             |         |             |                 |
|  |=============|         |=============|                 |
|                                                          |
|                                                          |
|                                                          |
|==========================================================|
