############################################################
############################# ## ###########    ############
############################################      ##########
###########           ######       #########       #########
###########           #####        #######         #########
##########            #####         #####           ########
##########            ###            ####           ########
##########            ##             ####             ######
##########    ##      ##     ##      ####                 ##
#######       ##      ##     ##      ########             ##
#####                 ##             ###########          ##
###                   ##              ############        ##
##                    ##              ##################  ##
#                     ##                    ############   #
#                     ##                                   #
#       ##            ##          ##                       #
#       ##            ##          ##                       #
#                     ##                            ##     #
#                                                   ##     #
#                                                          #
#                     #######               #              #
#                    #########             ###            ##
##                 #############         #######         ###
###              #################      ##########     #####
############################################################
