|==========================================================|
|..........................................................|
|...|==========|...........................................|
|...|..........|...........................................|
|...|..........|===========|=============|.................|
|...|....................................|......|========|.|
|...|..........|===========|.............|......|........|.|
|...|..........|...........|.............|......|........|.|
|...|..........|...........|.............|......|........|.|
|...|==========|...........|.............|......|........|.|
|..........................|.............|======|........|.|
|..........................|.............................|.|
|..|=============|.........|.............................|.|
|..|.............|.........|.............|======|........|.|
|..|.............|.........|.............|......|........|.|
|..|.............|=========|.............|......|........|.|
|..|.....................................|......|........|.|
|..|.............|=========|.............|......|========|.|
|..|.............|.........|.............|.................|
|..|.............|.........|.............|.................|
|..|=============|.........|=============|.................|
|..........................................................|
|..........................................................|
|..........................................................|
|==========================================================|
